                        


XXXXXXXXXXXXXXXXXXXXXXXXX     
XXXXXXXXXXXXXXXXXXXXXXXXX  
                                  

         XX    XX               
XX   XXXXXXXXXXXXXXX   XX             
           XXXX
XX   XXXXXXXXXXXXXXX   XX                           
         XX    XX             
                                
                     
XXXXXXXXXXXXXXXXXXXXXXXXX     
XXXXXXXXXXXXXXXXXXXXXXXXX
           