                        


XXXX    XXXX  XXXX   XXXX     
XXXX    XXXXXXXXXX   XXXX  
                                  
XXXXXXXXXXXXXXXXXXXXXXXXX
XXXX    XW     XL    XXXX           
SX   LXXXXXXLXXXXXXL   XX            
XXXXXXXXS  XWXX  XXXXWXXS
XX   LXXXXXXLXXXXXXL   XS                           
XXXX    XL     XX    XXXX        
XXXXXXXXXLXXXXXXXXXXXXXXX                                
                     
XXXX    X  X XXXXXX  X  X     
 XX     XXXX  XXX     XX   
           