                        


XXXXXXXXXXXXXXXXXXXXXXXXX        
XXXXXXXXXXCXXXCXXXCXXXXXX       
XXXX    XCXXLXXXCX   XXXX  
XXXXXX XXXXXSXXCXX XXXXSX                                  
XSXCX               XCXLX
XXXXX  WXLX   XLXW  XXXXX    
XWXXS   XX     XX   SXXWX           
XXCXXL             LXXCXX
XLXXXXX     SX    XXXXSXX            
XSCXXXXC   XCCX  XXXXXCXX
XXXXXXXXX XXLXXX XXXXXXXX                           
XXXXXXXXXXCXXXCXXCXXXXXXX        
XXXXXXXXXXXXXXXXXXXXXXXXX                                
                     
           