                        


XX    XXXXXXXXXXXX    XXX
XXX    XXXXXXXXXX    XXXX
XXXX    XCXXXCXX    XXXXX
XCXSX    XXCXXS    XXCXXX
XLXXXX    XLWX    XCSXXXX
XXSXLXX    XX    XXLXXCXX
XWXXCXXC   LC   CXXLXXXWX                    
XXXXCXX    XX    XXXSXXXX
XXCXXX    XWLX    XXXXXLX
XXSXX    XXCXXS    XXSXXX
XXCX    XCXXXXCX    XXXXX
XXX    XXXXXXXXXX    XXXX
XX    XXXXXXXXXXXX    XXX

